NO textures/wall.png
SO textures/wall.png
WE textures/wall.png
EA textures/wall.png

F 220,100,0
C 225,30,0
          
 11111
 10001
110N011
 10001
 11111