NO textures/wall.png
SO textures/wall.png
WE textures/wall.png
EA textures/wall.png

F 220,100,0
C 225,30,0

111111111111111111111111111111
111000000000000000000000000111
111010000000000000000000010111
111010100000000000000010101111
111010101000000000001010101111
11101010010000W000010010101111
111010000010000000100001011111
111000000000100000000000001111
111010000000100000000010101111
111010100000000000100010101111
111010100000000001000010101111
111000000000000000000000001111
111111111111111111111111111111