NO textures/wall.png
SO textures/wall.png
WE textures/wall.png
EA textures/wall.png

F 220,100,0
C 100,30,0

111111111111111111111111111111111
100000000000000000000001000000001
101111111111011111111101011111101
100000000001010000000000010000001
111111110101011111011111111110111
100000010101000001000000000010001
101111010111111101011111111011101
100001010000000001000000001000001
111101011111011111111101111111101
100101000001010000000001000000001
101111111101010111111101011111111
1000000000010001N0000001010000001
111111101111111111011111010111101
100000001000000001010000010100001
101111111111111101010111110111101
100000000000000001000000000000001
111111111101011111111101111111111
100000001001010000000001000000001
101111101101111011111101011111101
100000001000000010000001010000001
111111111111011111011111110111111
100000000000010000000001000000001
101111111111111111111111111111101
100000000000000000000000000000001
111111111111111111111111111111111